level3_4
----------------
-             D-
-  E      - C  -
-   E     -    -
-    E    -  C -
-----------    -
-              -
- P            -
----------------