level3_3
----------------
-          L   -
-  -           -
-  -    F  F   -
-  - L  F  F   -
-  -    F  F   -
-  -    F  F   -
- P-D      L   -
----------------