level1_2
----------------
-  D           -
-           E  -
-              -
-           E  -
-    R         -
-   PR         -
-              -
----------------