store2
----------------
-         F    -
-   F          -
-              -
-        F     -
-              -
-   P        RR--
-             D-
----------------