store1
----------------
-  D     F     -
-              -
-      --   F  -
-      --      -
-         F    -
-   P          -
-              -
----------------