store
----------------
-         E    -
-              -
-  D           -
-        E     -
-              -
-   P          -
-              -
----------------