level3_3
----------------
-              -
-  -           -
-  -    F  F   -
-  -    F  F   -
-  -    F  F   -
-  -    F  F   -
- P-D          -
----------------