store1
----------------
-  D     F     -
-     F    F   -
-      --      -
-      --   F  -
-              -
-   P          -
-              -
----------------