level1_1
----------------
-              -
-   P R        -
-RRRRRR        -
-        F     -
-   E          -
-              -
- D        E   -
----------------