store
----------------
-  D           -
-              -
-  E           -
-        E     -
-              -
-   P          -
-              -
----------------