level3_2
----------------
- L          L -
-   P R        -
-RRRRRR        -
-        F     -
-   E          -
-              -
- D        E L -
----------------