store1
----------------
-  D     F     -
-     F L  F   -
-      --      -
-      --   F  -
-       L      -
-   P          -
-              -
----------------