level1_2
----------------
-  D           -
-      L    E  -
-              -
-           E  -
-    R         -
-   PR    L    -
-              -
----------------