level2_2
----------------
-          F   -
- P        F   -
-        -------
-        -     -
-        -  E  -
-   C    -     -
-             D-
----------------