level2_2
----------------
-              -
-         E    -
-  D           -
-        E     -
-              -
-   P          -
-              -
----------------