level2_2
----------------
-          F   -
- P  L     F   -
-        -------
-        -     -
-        -  E  -
-   C    -     -
-  L          D-
----------------