level3_4
----------------
-             D-
-  E      - C  -
-   E  L  -    -
-    E    -  C -
-----------    -
-              -
- P         L  -
----------------