level1_2
----------------
-  D           -
-            F -
-   C          -
-              -
-  RRR         -
-  RPR         -
-              -
----------------