level2_3
----------------
-         F    -
-   F    L     -
-              -
-        F     -
-              -
-   P        RR-
-      L      D-
----------------