level1_2
----------------
-  D           -
-              -
-  E           -
-        F     -
-  RRR         -
-  RPR         -
-              -
----------------